thisClass=this class
impossible=impossible
addition=addition
subtraction=subtraction
division=division
multiplication=multiplication
unknownVariable=Unknown variable
matrixAndVector=It is impossible to lay down a matrix and a vector
sizeMatrix=The uneven size of the matrices
vectorSubMatrix=Cannot subtract a vector from a matrix
MatricesIncompatible=Matrices are incompatible
MatrixAndVectorIncompatible=Matrix and vector are incompatible
vectorMulMatrix=it is impossible to multiply the vector by the matrix
matrixDivMatrix=A matrix cannot be divided into a matrix
matrixDivVector=The matrix cannot be divided by a vector
numberDivMatrix=You cannot divide a number by a matrix
divisionByZero=division by zero
numberDivVectorOrMAtrix=Cannot divide a number by a vector or matrix
sizeVectors=The unequal size of the vectors
vectorDivVector=It is impossible to divide a vector by a vector
vectorDivMatrix=It is impossible to divide a vector by a matrix
ERROR=ERROR:
IncorrectCalculation1=Incorrect calculation 1
IncorrectCalculation2=Incorrect calculation 2
IncorrectCalculation3=Incorrect calculation 3
IncorrectCalculation4=Incorrect calculation 4
IncorrectCalculation5=Incorrect calculation 5
IncorrectCalculation6=Incorrect calculation 6
IncorrectVariableA=Incorrect creation of variable A
IncorrectFirstVector=Incorrect first wyciszenie vector
IncorrectSecondVector=Incorrect second wyciszenie vector
end=to exit the program you need to write the output
exit=exit
IncorrectVectorN=Incorrect creation of vector N
IncorrectFirstMatrix=Incorrect first wyciszenie matrix
IncorrectSecondMatrix=Incorrect second wyciszenie matrix
IncorrectThirdMatrix=Incorrect third wyciszenie matrix
IncorrectMatrixM=Incorrect creation of matrix m
