thisClass=Гэта класс
impossible=Немагчыма
addition=Складанне
subtraction=Адыманне
division=Дзяленне
multiplication=Множанне
unknownVariable=Невядомая зменная
matrixAndVector=Немагчыма скласці матрыцу і вектар
sizeMatrix=Неаднолькавыя памеры матрыц
vectorSubMatrix=Немагчыма адняць вектар ад матрыцы
MatricesIncompatible=Матрыцы несумяшчальныя
MatrixAndVectorIncompatible=Матрыца і вектар несумяшчальныя
vectorMulMatrix=немагчыма памножыць вектар на матрыцу
matrixDivMatrix=Матрицу нельзя делить на матрицу
matrixDivVector=Матрыцу нельга дзяліць на матрыцу
numberDivMatrix=Нельга дзяліць лік на матрыцу
divisionByZero=Дзяленне на нуль
numberDivVectorOrMAtrix=Немагчыма падзяліць лік на вектар або матрыцу
sizeVectors=Неаднолькавыя памеры вектараў
vectorDivVector=Немагчыма падзяліць на вектар вектар
vectorDivMatrix=Немагчыма падзяліць вектар на матрыцу
ERROR=ПАМЫЛКА:
IncorrectCalculation1=Некарэктнае Вылічэнне 1
IncorrectCalculation2=Некарэктнае Вылічэнне 2
IncorrectCalculation3=Некарэктнае Вылічэнне 3
IncorrectCalculation4=Некарэктнае Вылічэнне 4
IncorrectCalculation5=ННекарэктнае Вылічэнне 5
IncorrectCalculation6=Некарэктнае Вылічэнне 6
IncorrectVariableA=Некарэктнае стварэнне зменнай А
IncorrectFirstVector=Некарэктнае першае вылічэнне з вектарам
IncorrectSecondVector=Некарэктнае другое вылічэнне з вектарам
end=для выхаду з праграмы трэба напісаць выхад
exit=выхад
IncorrectVectorN=Некарэктнае стварэнне вектара N
IncorrectFirstMatrix=Некарэктнае першае вылічэнне з матрыцай
IncorrectSecondMatrix=Некарэктнае другое вылічэнне з матрыцай
IncorrectThirdMatrix=Некарэктнае трэцяе вылічэнне з матрыцай
IncorrectMatrixM=Некарэктнае стварэнне матрыцы m
locale=якую лакаль жадаеце выкарыстоўваць?en, be, ru
