thisClass=Это класс
impossible=Невозможно
addition=Сложение
subtraction=Вычитание
division=Деление
multiplication=Умножение
unknownVariable=Неисвестная переменная
matrixAndVector=Невозможно сложить матрицу и вектор
sizeMatrix=Неодинаковы размер матриц
vectorSubMatrix=Невозможно отнять вектор от матрицы
MatricesIncompatible=Матрицы несовместимы
MatrixAndVectorIncompatible=Матрица и вектор несовместимы
vectorMulMatrix=невозможно умножить вектор на матрицу
matrixDivMatrix=Матрицу нельзя делить на матрицу
matrixDivVector=Матрицу нельзя делить на вектор
numberDivMatrix=Нельзя делить число на матрицу
divisionByZero=Деление на ноль
numberDivVectorOrMAtrix=Невозможно разделить число на вектор или матрицу
sizeVectors=Неодинаковые размеры векторов
vectorDivVector=Невозможно разделить вектор на вектор
vectorDivMatrix=Невозможно разделить вектор на матрицу
ERROR=ОШИБКА:
IncorrectCalculation1=НЕкорректрое вычисление 1
IncorrectCalculation2=НЕкорректрое вычисление 2
IncorrectCalculation3=НЕкорректрое вычисление 3
IncorrectCalculation4=НЕкорректрое вычисление 4
IncorrectCalculation5=НЕкорректрое вычисление 5
IncorrectCalculation6=НЕкорректрое вычисление 6
IncorrectVariableA=НЕкореккстное создание переменной А
IncorrectFirstVector=НЕкорректное первое вычисение с вектором
IncorrectSecondVector=НЕкорректное второе вычисение с вектором
end=для выхода из программы нужно написать выход
exit=выход
IncorrectVectorN=НЕкорректное создание вектора N
IncorrectFirstMatrix=НЕкорректное первое вычисение с матрицей
IncorrectSecondMatrix=НЕкорректное второе вычисение с матрицей
IncorrectThirdMatrix=НЕкорректное третье вычисение с матрицей
IncorrectMatrixM=НЕкорректное создание матрицы m
locale=какую локаль хотите использовать? en, be, ru